1111111
1P00B01
100C0C1
1E00B01
1111111