1111111111111111111111
10000000000000000C0001
1000C00000000000000001
1000000000000B00000001
100000000000000C000001
10000000000C0000000001
100B0000C0000000000001
1000000000000000E00001
1000000000000000000001
100000000000000B000001
10000000C0000000000001
10P0000000000000000001
1111111111111111111111