1111111
1P00001
1111101
10C0E01
1111111